############################################################################################
#.................................#######........................................V.........#
#.................................#######..................................................#
#.......................<.........#######..................................................#
#.................................#######..................................................#
#.................................#######..................................................#
#.................................#######..................................................#
#.................................#######..................................................#
#.................................#######..................................................#
#.................................#######..................................................#
#..........................................................................................#
#..@..................................................A....................................#
#..........................................................................................#
############################################################################################
